0 0 0 0 0 0 0 0 0 0 0 0 0 0 0 
3 3 3 3 3 0 0 0 0 0 0 0 0 0 0 
0 0 3 0 0 0 0 0 0 0 0 0 0 0 0 
0 0 3 0 0 0 0 0 0 0 0 0 0 0 0 
0 0 3 0 3 0 0 0 0 0 0 0 0 0 0 
0 0 0 3 0 3 0 0 0 2 2 2 4 4 4 
0 0 3 3 3 3 3 0 0 0 0 0 0 0 0 
0 3 0 0 0 0 0 3 0 0 0 0 0 0 0 
0 0 0 0 0 0 3 0 0 0 3 0 0 0 0 
0 0 0 0 0 0 3 3 0 3 3 0 0 0 0 
4 4 4 1 1 1 3 0 3 0 3 0 0 3 0 
0 0 0 0 0 0 3 0 0 0 3 0 3 0 0 
0 0 0 0 0 0 0 0 0 0 3 3 0 0 0 
0 0 0 0 0 0 3 3 3 0 3 0 3 0 0 
0 0 0 0 0 0 3 5 3 0 3 0 0 3 0