0 0 0 0 0 0 0 0 0 0 0 0 0 0 0 
0 0 0 0 3 0 0 0 0 0 3 2 0 0 0 
0 0 0 0 3 0 0 3 0 0 3 2 0 0 0 
0 0 0 2 3 4 1 3 1 4 3 2 0 0 0 
0 0 0 2 3 4 1 3 1 4 3 0 0 0 0 
0 0 0 2 3 4 1 3 1 4 3 0 0 0 0 
3 3 3 0 0 0 0 3 0 0 0 0 3 3 3 
3 3 3 2 3 0 2 3 2 0 3 0 3 3 3 
0 0 0 2 3 4 0 3 0 4 3 0 0 0 0 
0 0 0 2 3 4 1 3 1 4 3 2 0 0 0 
0 0 0 0 3 0 1 3 1 0 3 2 0 0 0 
0 0 0 0 2 2 0 0 0 2 2 2 0 0 0 
0 0 0 0 0 0 0 0 0 0 0 0 0 0 0 
0 0 0 0 0 0 3 3 3 0 0 0 0 0 0 
0 0 0 0 0 0 3 5 3 0 0 0 0 0 0