0 0 0 0 0 0 0 0 0 0 0 0 0 0 0 
3 0 0 0 0 0 0 0 0 0 0 0 0 3 0 
0 3 0 0 3 3 3 3 3 3 3 0 3 0 0 
0 0 3 0 0 0 0 0 0 0 0 3 0 0 0 
0 0 0 3 2 2 1 1 1 2 3 0 0 0 0 
0 3 4 0 3 0 0 0 0 3 0 4 0 3 0 
3 0 4 0 0 3 0 0 3 0 0 4 0 0 3 
0 0 4 0 0 0 3 3 0 0 0 4 0 0 0 
0 3 4 0 0 0 3 3 0 0 0 4 0 3 0 
0 3 4 0 0 3 0 0 3 0 0 4 0 3 0 
0 0 0 0 3 0 0 0 0 3 0 0 0 0 0 
0 0 0 3 2 1 1 1 2 2 3 0 0 0 0 
0 0 3 0 0 0 0 0 0 0 0 3 0 0 0 
0 3 0 0 0 0 3 3 3 0 0 0 3 0 0 
0 0 0 0 0 0 3 5 3 0 0 0 0 0 0